# Key for Emoji Communication Tool
# Format: word=emoji
# DO NOT SHARE THIS FILE PUBLICLY

hello=ğŸ¦Š
world=ğŸ„
brother=ğŸ¦‹
how=ğŸ”§
are=ğŸªœ
you=ğŸªµ
i=ğŸª¨
am=ğŸŒ¿
good=ğŸ„
bad=ğŸª±
ok=ğŸ¦´
yes=ğŸª¬
no=ğŸ«¥
love=ğŸª·
bye=ğŸª¦
thanks=ğŸª®
please=ğŸª¯
sorry=ğŸª°
the=ğŸª±
and=ğŸª²
is=ğŸª³
it=ğŸª´
of=ğŸªµ
in=ğŸª¶
to=ğŸª·
for=ğŸª¸
have=ğŸª¹
this=ğŸªº
that=ğŸª»
by=ğŸª¼
from=ğŸª½
as=ğŸª¾
on=ğŸª¿
be=ğŸ«€
at=ğŸ«
we=ğŸ«‚
can=ğŸ«ƒ
an=ğŸ«„
will=ğŸ«…
my=ğŸ«†
would=ğŸ«‡
there=ğŸ«ˆ
their=ğŸ«‰
what=ğŸ«Š
so=ğŸ«‹
if=ğŸ«Œ
about=ğŸ«
which=ğŸ«
them=ğŸ«
get=ğŸ«
may=ğŸ«‘
than=ğŸ«’
call=ğŸ«“
time=ğŸ«”
come=ğŸ«•
his=ğŸ«–
your=ğŸ«—
now=ğŸ«˜
want=ğŸ«™
look=ğŸ«š
way=ğŸ«›
make=ğŸ«œ
could=ğŸ«
first=ğŸ«
been=ğŸ«Ÿ
here=ğŸ« 
like=ğŸ«¡
other=ğŸ«¢
into=ğŸ«£
has=ğŸ«¤
more=ğŸ«¥
its=ğŸ«¦
only=ğŸ«§
who=ğŸ«¨
new=ğŸ«©
some=ğŸ«ª
take=ğŸ««
come=ğŸ«¬
her=ğŸ«­
would=ğŸ«®
make=ğŸ«¯
